* *9* ** *
* * ***7**
* **** ***
*    * * *
**** **6**
* ** ** **