**** *****
**** * * *
** *  ** *
* ** **  *
***  *9* *
*** * ****
* *   ****
*7**  ****
****   ***
*   *    *
**1** ****