** **** **
*  *******
** ** * **
*  * ** **
* *** **3*
* ** *****
*  *** ***
* *** ** *
* ** *** *