* *9* ** *
* * ***8**
* **** ***
** * * * *
**** **6**
* ** ** **
**** *****
**** * * *
** *3 ** *
* *****  *
*** **9* *
***   ****
* ********
*7**  ****
*****  ***
*        *
**1** ****
** **** **
*  *******
** ** * **
*  * ** **
* *** **3*
* ** *****
*  *** ***
* *** ** *
* ** *** *